11 12 1 12 12 1 1 1 12 12 12 12 3
4 0 1 0 0 1 10 0 1 0 0 0 9
4 0 1 0 0 0 10 0 1 0 0 0 9
4 0 1 0 0 1 10 0 1 0 0 1 9
4 0 1 0 0 1 10 0 1 0 0 1 9
4 0 1 0 0 1 10 0 1 0 1 1 9
4 0 1 0 0 1 10 0 1 0 0 0 1
4 0 0 0 0 1 10 0 0 0 0 0 1
4 0 1 0 0 1 10 0 0 0 0 0 9
5 6 1 6 6 1 1 6 6 6 1 1 1